GWBBBBBBBB
BWBBBBBBBB
BWBBWWWWWB
BWBBWBBBWB
BWBBWBBBWB
BWBBWBBBWB
BWBBWBBBRB
BWWWWBBBBB
BBBBBBBBBB
BBBBBBBBBB
