GBBBBBBBBW
BBBBBBBBBW
BBBWBBBBBW
BBBWBBBBBW
BBBWBBBBBW
BBBWBBBBBW
BBBWBBBBBW
BBBWBBBBBW
BBBBBBBBBW
RBBBBBBBBW
